provincia,cantón,área_de_residencia,número_total_de_personas,hombres,mujeres
AZUAY,Total Azuay,Total Azuay,801609,376419,425190
AZUAY,Total Azuay,Urbana,420141,198877,221264
AZUAY,Total Azuay,Rural,381468,177542,203926
AZUAY,Cuenca,Total Cuenca,596101,281823,314278
AZUAY,Cuenca,Urbana,361524,171684,189840
AZUAY,Cuenca,Rural,234577,110139,124438
AZUAY,Girón,Total Girón,12182,5532,6650
AZUAY,Girón,Urbana,4353,1952,2401
AZUAY,Girón,Rural,7829,3580,4249
AZUAY,Gualaceo,Total Gualaceo,43188,19421,23767
AZUAY,Gualaceo,Urbana,13843,6307,7536
AZUAY,Gualaceo,Rural,29345,13114,16231
AZUAY,Nabón,Total Nabón,14776,6729,8047
AZUAY,Nabón,Urbana,1276,550,726
AZUAY,Nabón,Rural,13500,6179,7321
AZUAY,Paute,Total Paute,26782,12201,14581
AZUAY,Paute,Urbana,8766,4030,4736
AZUAY,Paute,Rural,18016,8171,9845
AZUAY,Pucará,Total Pucará,9693,4604,5089
AZUAY,Pucará,Urbana,855,416,439
AZUAY,Pucará,Rural,8838,4188,4650
AZUAY,San Fernando,Total San Fernando,3738,1656,2082
AZUAY,San Fernando,Urbana,1407,637,770
AZUAY,San Fernando,Rural,2331,1019,1312
AZUAY,Santa Isabel,Total Santa Isabel,20753,9914,10839
AZUAY,Santa Isabel,Urbana,6194,2948,3246
AZUAY,Santa Isabel,Rural,14559,6966,7593
AZUAY,Sígsig,Total Sígsig,24992,11016,13976
AZUAY,Sígsig,Urbana,4029,1851,2178
AZUAY,Sígsig,Rural,20963,9165,11798
AZUAY,Oña,Total Oña,3422,1575,1847
AZUAY,Oña,Urbana,989,456,533
AZUAY,Oña,Rural,2433,1119,1314
AZUAY,Chordeleg,Total Chordeleg,12197,5494,6703
AZUAY,Chordeleg,Urbana,4445,2086,2359
AZUAY,Chordeleg,Rural,7752,3408,4344
AZUAY,El Pan,Total El Pan,2776,1280,1496
AZUAY,El Pan,Urbana,503,225,278
AZUAY,El Pan,Rural,2273,1055,1218
AZUAY,Sevilla de Oro,Total Sevilla de Oro,4613,2167,2446
AZUAY,Sevilla de Oro,Urbana,732,345,387
AZUAY,Sevilla de Oro,Rural,3881,1822,2059
AZUAY,Guachapala,Total Guachapala,3586,1714,1872
AZUAY,Guachapala,Urbana,1210,556,654
AZUAY,Guachapala,Rural,2376,1158,1218
AZUAY,Camilo Ponce Enríquez,Total Camilo Ponce Enríquez,22810,11293,11517
AZUAY,Camilo Ponce Enríquez,Urbana,10015,4834,5181
AZUAY,Camilo Ponce Enríquez,Rural,12795,6459,6336
BOLIVAR,Total Bolívar,Total Bolívar,199078,95873,103205
BOLIVAR,Total Bolívar,Urbana,64172,30351,33821
BOLIVAR,Total Bolívar,Rural,134906,65522,69384
BOLIVAR,Guaranda,Total Guaranda,98130,46659,51471
BOLIVAR,Guaranda,Urbana,30755,14508,16247
BOLIVAR,Guaranda,Rural,67375,32151,35224
BOLIVAR,Chillanes,Total Chillanes,19802,9844,9958
BOLIVAR,Chillanes,Urbana,3251,1544,1707
BOLIVAR,Chillanes,Rural,16551,8300,8251
BOLIVAR,Chimbo,Total Chimbo,15524,7438,8086
BOLIVAR,Chimbo,Urbana,4354,2050,2304
BOLIVAR,Chimbo,Rural,11170,5388,5782
BOLIVAR,Echeandía,Total Echeandía,14654,7197,7457
BOLIVAR,Echeandía,Urbana,7138,3435,3703
BOLIVAR,Echeandía,Rural,7516,3762,3754
BOLIVAR,San Miguel,Total San Miguel,28349,13655,14694
BOLIVAR,San Miguel,Urbana,8806,4122,4684
BOLIVAR,San Miguel,Rural,19543,9533,10010
BOLIVAR,Caluma,Total Caluma,15607,7570,8037
BOLIVAR,Caluma,Urbana,7884,3741,4143
BOLIVAR,Caluma,Rural,7723,3829,3894
BOLIVAR,Las Naves,Total Las Naves,7012,3510,3502
BOLIVAR,Las Naves,Urbana,1984,951,1033
BOLIVAR,Las Naves,Rural,5028,2559,2469
CANAR,Total Cañar,Total Cañar,227578,104994,122584
CANAR,Total Cañar,Urbana,101098,47234,53864
CANAR,Total Cañar,Rural,126480,57760,68720
CANAR,Azogues,Total Azogues,74515,34120,40395
CANAR,Azogues,Urbana,35763,16590,19173
CANAR,Azogues,Rural,38752,17530,21222
CANAR,Biblián,Total Biblián,18852,8286,10566
CANAR,Biblián,Urbana,5728,2572,3156
CANAR,Biblián,Rural,13124,5714,7410
CANAR,Cañar,Total Cañar,52150,23809,28341
CANAR,Cañar,Urbana,13148,6099,7049
CANAR,Cañar,Rural,39002,17710,21292
CANAR,La Troncal,Total La Troncal,62103,29791,32312
CANAR,La Troncal,Urbana,39600,18826,20774
CANAR,La Troncal,Rural,22503,10965,11538
CANAR,El Tambo,Total El Tambo,9285,4250,5035
CANAR,El Tambo,Urbana,5202,2396,2806
CANAR,El Tambo,Rural,4083,1854,2229
CANAR,Déleg,Total Déleg,6046,2700,3346
CANAR,Déleg,Urbana,645,271,374
CANAR,Déleg,Rural,5401,2429,2972
CANAR,Suscal,Total Suscal,4627,2038,2589
CANAR,Suscal,Urbana,1012,480,532
CANAR,Suscal,Rural,3615,1558,2057
CARCHI,Total Carchi,Total Carchi,172828,84553,88275
CARCHI,Total Carchi,Urbana,87957,42521,45436
CARCHI,Total Carchi,Rural,84871,42032,42839
CARCHI,Tulcán,Total Tulcán,92375,44900,47475
CARCHI,Tulcán,Urbana,56719,27281,29438
CARCHI,Tulcán,Rural,35656,17619,18037
CARCHI,Bolívar,Total Bolívar,15677,7823,7854
CARCHI,Bolívar,Urbana,3377,1671,1706
CARCHI,Bolívar,Rural,12300,6152,6148
CARCHI,Espejo,Total Espejo,14522,7138,7384
CARCHI,Espejo,Urbana,5181,2534,2647
CARCHI,Espejo,Rural,9341,4604,4737
CARCHI,Mira,Total Mira,12727,6328,6399
CARCHI,Mira,Urbana,3691,1752,1939
CARCHI,Mira,Rural,9036,4576,4460
CARCHI,Montúfar,Total Montúfar,29590,14427,15163
CARCHI,Montúfar,Urbana,14497,7036,7461
CARCHI,Montúfar,Rural,15093,7391,7702
CARCHI,San Pedro de Huaca,Total San Pedro de Huaca,7937,3937,4000
CARCHI,San Pedro de Huaca,Urbana,4492,2247,2245
CARCHI,San Pedro de Huaca,Rural,3445,1690,1755
COTOPAXI,Total Cotopaxi,Total Cotopaxi,470210,227616,242594
COTOPAXI,Total Cotopaxi,Urbana,156481,74948,81533
COTOPAXI,Total Cotopaxi,Rural,313729,152668,161061
COTOPAXI,Latacunga,Total Latacunga,217261,106010,111251
COTOPAXI,Latacunga,Urbana,77267,36927,40340
COTOPAXI,Latacunga,Rural,139994,69083,70911
COTOPAXI,La Maná,Total La Maná,53793,26389,27404
COTOPAXI,La Maná,Urbana,31740,15438,16302
COTOPAXI,La Maná,Rural,22053,10951,11102
COTOPAXI,Pangua,Total Pangua,21867,10926,10941
COTOPAXI,Pangua,Urbana,1872,873,999
COTOPAXI,Pangua,Rural,19995,10053,9942
COTOPAXI,Pujilí,Total Pujilí,66980,31579,35401
COTOPAXI,Pujilí,Urbana,16152,7643,8509
COTOPAXI,Pujilí,Rural,50828,23936,26892
COTOPAXI,Salcedo,Total Salcedo,67493,32200,35293
COTOPAXI,Salcedo,Urbana,16751,7959,8792
COTOPAXI,Salcedo,Rural,50742,24241,26501
COTOPAXI,Saquisilí,Total Saquisilí,24356,11498,12858
COTOPAXI,Saquisilí,Urbana,9883,4773,5110
COTOPAXI,Saquisilí,Rural,14473,6725,7748
COTOPAXI,Sigchos,Total Sigchos,18460,9014,9446
COTOPAXI,Sigchos,Urbana,2816,1335,1481
COTOPAXI,Sigchos,Rural,15644,7679,7965
CHIMBORAZO,Total Chimborazo,Total Chimborazo,471933,223460,248473
CHIMBORAZO,Total Chimborazo,Urbana,224667,106106,118561
CHIMBORAZO,Total Chimborazo,Rural,247266,117354,129912
CHIMBORAZO,Riobamba,Total Riobamba,260882,123488,137394
CHIMBORAZO,Riobamba,Urbana,177213,83847,93366
CHIMBORAZO,Riobamba,Rural,83669,39641,44028
CHIMBORAZO,Alausí,Total Alausí,37275,17575,19700
CHIMBORAZO,Alausí,Urbana,6071,2780,3291
CHIMBORAZO,Alausí,Rural,31204,14795,16409
CHIMBORAZO,Colta,Total Colta,30468,14425,16043
CHIMBORAZO,Colta,Urbana,2785,1296,1489
CHIMBORAZO,Colta,Rural,27683,13129,14554
CHIMBORAZO,Chambo,Total Chambo,13431,6367,7064
CHIMBORAZO,Chambo,Urbana,5462,2646,2816
CHIMBORAZO,Chambo,Rural,7969,3721,4248
CHIMBORAZO,Chunchi,Total Chunchi,10635,4935,5700
CHIMBORAZO,Chunchi,Urbana,3799,1749,2050
CHIMBORAZO,Chunchi,Rural,6836,3186,3650
CHIMBORAZO,Guamote,Total Guamote,35769,17007,18762
CHIMBORAZO,Guamote,Urbana,3076,1442,1634
CHIMBORAZO,Guamote,Rural,32693,15565,17128
CHIMBORAZO,Guano,Total Guano,48327,22811,25516
CHIMBORAZO,Guano,Urbana,9136,4290,4846
CHIMBORAZO,Guano,Rural,39191,18521,20670
CHIMBORAZO,Pallatanga,Total Pallatanga,11796,5677,6119
CHIMBORAZO,Pallatanga,Urbana,4266,1999,2267
CHIMBORAZO,Pallatanga,Rural,7530,3678,3852
CHIMBORAZO,Penipe,Total Penipe,6748,3202,3546
CHIMBORAZO,Penipe,Urbana,1417,662,755
CHIMBORAZO,Penipe,Rural,5331,2540,2791
CHIMBORAZO,Cumandá,Total Cumandá,16602,7973,8629
CHIMBORAZO,Cumandá,Urbana,11442,5395,6047
CHIMBORAZO,Cumandá,Rural,5160,2578,2582
EL ORO,Total El Oro,Total El Oro,714592,353211,361381
EL ORO,Total El Oro,Urbana,561225,274575,286650
EL ORO,Total El Oro,Rural,153367,78636,74731
EL ORO,Machala,Total Machala,306309,150682,155627
EL ORO,Machala,Urbana,288072,141364,146708
EL ORO,Machala,Rural,18237,9318,8919
EL ORO,Arenillas,Total Arenillas,32366,16041,16325
EL ORO,Arenillas,Urbana,21524,10485,11039
EL ORO,Arenillas,Rural,10842,5556,5286
EL ORO,Atahualpa,Total Atahualpa,6112,3117,2995
EL ORO,Atahualpa,Urbana,1769,883,886
EL ORO,Atahualpa,Rural,4343,2234,2109
EL ORO,Balsas,Total Balsas,7875,4058,3817
EL ORO,Balsas,Urbana,4500,2305,2195
EL ORO,Balsas,Rural,3375,1753,1622
EL ORO,Chilla,Total Chilla,2251,1105,1146
EL ORO,Chilla,Urbana,910,422,488
EL ORO,Chilla,Rural,1341,683,658
EL ORO,El Guabo,Total El Guabo,59536,30181,29355
EL ORO,El Guabo,Urbana,26635,13157,13478
EL ORO,El Guabo,Rural,32901,17024,15877
EL ORO,Huaquillas,Total Huaquillas,56303,27447,28856
EL ORO,Huaquillas,Urbana,56021,27249,28772
EL ORO,Huaquillas,Rural,282,198,84
EL ORO,Marcabelí,Total Marcabelí,6870,3535,3335
EL ORO,Marcabelí,Urbana,4973,2522,2451
EL ORO,Marcabelí,Rural,1897,1013,884
EL ORO,Pasaje,Total Pasaje,83597,40983,42614
EL ORO,Pasaje,Urbana,60147,29135,31012
EL ORO,Pasaje,Rural,23450,11848,11602
EL ORO,Piñas,Total Piñas,29406,14720,14686
EL ORO,Piñas,Urbana,18482,9033,9449
EL ORO,Piñas,Rural,10924,5687,5237
EL ORO,Portovelo,Total Portovelo,13556,6824,6732
EL ORO,Portovelo,Urbana,9764,4856,4908
EL ORO,Portovelo,Rural,3792,1968,1824
EL ORO,Santa Rosa,Total Santa Rosa,80299,39522,40777
EL ORO,Santa Rosa,Urbana,56842,27465,29377
EL ORO,Santa Rosa,Rural,23457,12057,11400
EL ORO,Zaruma,Total Zaruma,24374,12076,12298
EL ORO,Zaruma,Urbana,10005,4928,5077
EL ORO,Zaruma,Rural,14369,7148,7221
EL ORO,Las Lajas,Total Las Lajas,5738,2920,2818
EL ORO,Las Lajas,Urbana,1581,771,810
EL ORO,Las Lajas,Rural,4157,2149,2008
ESMERALDAS,Total Esmeraldas,Total Esmeraldas,553900,268848,285052
ESMERALDAS,Total Esmeraldas,Urbana,248586,116303,132283
ESMERALDAS,Total Esmeraldas,Rural,305314,152545,152769
ESMERALDAS,Esmeraldas,Total Esmeraldas,211848,100074,111774
ESMERALDAS,Esmeraldas,Urbana,155487,72097,83390
ESMERALDAS,Esmeraldas,Rural,56361,27977,28384
ESMERALDAS,Eloy Alfaro,Total Eloy Alfaro,46305,22795,23510
ESMERALDAS,Eloy Alfaro,Urbana,4956,2254,2702
ESMERALDAS,Eloy Alfaro,Rural,41349,20541,20808
ESMERALDAS,Muisne,Total Muisne,36426,18424,18002
ESMERALDAS,Muisne,Urbana,5574,2822,2752
ESMERALDAS,Muisne,Rural,30852,15602,15250
ESMERALDAS,Quinindé,Total Quinindé,126841,63368,63473
ESMERALDAS,Quinindé,Urbana,31120,14825,16295
ESMERALDAS,Quinindé,Rural,95721,48543,47178
ESMERALDAS,San Lorenzo,Total San Lorenzo,48391,23071,25320
ESMERALDAS,San Lorenzo,Urbana,28491,13275,15216
ESMERALDAS,San Lorenzo,Rural,19900,9796,10104
ESMERALDAS,Atacames,Total Atacames,51204,24835,26369
ESMERALDAS,Atacames,Urbana,18948,9126,9822
ESMERALDAS,Atacames,Rural,32256,15709,16547
ESMERALDAS,Rioverde,Total Rioverde,32885,16281,16604
ESMERALDAS,Rioverde,Urbana,4010,1904,2106
ESMERALDAS,Rioverde,Rural,28875,14377,14498
GUAYAS,Total Guayas,Total Guayas,4391923,2154292,2237631
GUAYAS,Total Guayas,Urbana,3744462,1826125,1918337
GUAYAS,Total Guayas,Rural,647461,328167,319294
GUAYAS,Guayaquil,Total Guayaquil,2746403,1344265,1402138
GUAYAS,Guayaquil,Urbana,2650288,1295478,1354810
GUAYAS,Guayaquil,Rural,96115,48787,47328
GUAYAS,Alfredo Baquerizo Moreno (Juján),Total Alfredo Baquerizo Moreno (Juján),25526,12720,12806
GUAYAS,Alfredo Baquerizo Moreno (Juján),Urbana,6035,2896,3139
GUAYAS,Alfredo Baquerizo Moreno (Juján),Rural,19491,9824,9667
GUAYAS,Balao,Total Balao,25655,12981,12674
GUAYAS,Balao,Urbana,12850,6489,6361
GUAYAS,Balao,Rural,12805,6492,6313
GUAYAS,Balzar,Total Balzar,57829,28732,29097
GUAYAS,Balzar,Urbana,32744,15974,16770
GUAYAS,Balzar,Rural,25085,12758,12327
GUAYAS,Colimes,Total Colimes,26251,13439,12812
GUAYAS,Colimes,Urbana,7619,3738,3881
GUAYAS,Colimes,Rural,18632,9701,8931
GUAYAS,Daule,Total Daule,222446,106825,115621
GUAYAS,Daule,Urbana,161498,76420,85078
GUAYAS,Daule,Rural,60948,30405,30543
GUAYAS,Durán,Total Durán,303910,148306,155604
GUAYAS,Durán,Urbana,295211,143842,151369
GUAYAS,Durán,Rural,8699,4464,4235
GUAYAS,El Empalme,Total El Empalme,79767,39498,40269
GUAYAS,El Empalme,Urbana,41778,20145,21633
GUAYAS,El Empalme,Rural,37989,19353,18636
GUAYAS,El Triunfo,Total El Triunfo,60541,29737,30804
GUAYAS,El Triunfo,Urbana,41042,19942,21100
GUAYAS,El Triunfo,Rural,19499,9795,9704
GUAYAS,Milagro,Total Milagro,195943,95390,100553
GUAYAS,Milagro,Urbana,159970,77547,82423
GUAYAS,Milagro,Rural,35973,17843,18130
GUAYAS,Naranjal,Total Naranjal,83691,41901,41790
GUAYAS,Naranjal,Urbana,39323,19224,20099
GUAYAS,Naranjal,Rural,44368,22677,21691
GUAYAS,Naranjito,Total Naranjito,44169,21637,22532
GUAYAS,Naranjito,Urbana,34664,16911,17753
GUAYAS,Naranjito,Rural,9505,4726,4779
GUAYAS,Palestina,Total Palestina,18019,9079,8940
GUAYAS,Palestina,Urbana,10392,5148,5244
GUAYAS,Palestina,Rural,7627,3931,3696
GUAYAS,Pedro Carbo,Total Pedro Carbo,52177,26458,25719
GUAYAS,Pedro Carbo,Urbana,24882,12344,12538
GUAYAS,Pedro Carbo,Rural,27295,14114,13181
GUAYAS,Samborondón,Total Samborondón,98540,47699,50841
GUAYAS,Samborondón,Urbana,72425,34563,37862
GUAYAS,Samborondón,Rural,26115,13136,12979
GUAYAS,Santa Lucía,Total Santa Lucía,43700,22273,21427
GUAYAS,Santa Lucía,Urbana,10924,5378,5546
GUAYAS,Santa Lucía,Rural,32776,16895,15881
GUAYAS,Salitre,Total Salitre,61060,30716,30344
GUAYAS,Salitre,Urbana,13571,6564,7007
GUAYAS,Salitre,Rural,47489,24152,23337
GUAYAS,San Jacinto de Yaguachi,Total San Jacinto de Yaguachi,72699,36026,36673
GUAYAS,San Jacinto de Yaguachi,Urbana,22972,11095,11877
GUAYAS,San Jacinto de Yaguachi,Rural,49727,24931,24796
GUAYAS,Playas,Total Playas,58768,29099,29669
GUAYAS,Playas,Urbana,48156,23816,24340
GUAYAS,Playas,Rural,10612,5283,5329
GUAYAS,Simón Bolívar,Total Simón Bolívar,29427,14820,14607
GUAYAS,Simón Bolívar,Urbana,8696,4236,4460
GUAYAS,Simón Bolívar,Rural,20731,10584,10147
GUAYAS,Coronel Marcelino Maridueña,Total Coronel Marcelino Maridueña,13183,6701,6482
GUAYAS,Coronel Marcelino Maridueña,Urbana,7796,3917,3879
GUAYAS,Coronel Marcelino Maridueña,Rural,5387,2784,2603
GUAYAS,Lomas de Sargentillo,Total Lomas de Sargentillo,22254,11195,11059
GUAYAS,Lomas de Sargentillo,Urbana,16603,8269,8334
GUAYAS,Lomas de Sargentillo,Rural,5651,2926,2725
GUAYAS,Nobol,Total Nobol,23850,11771,12079
GUAYAS,Nobol,Urbana,10010,4878,5132
GUAYAS,Nobol,Rural,13840,6893,6947
GUAYAS,General  Antonio Elizalde,Total General  Antonio Elizalde,11810,5775,6035
GUAYAS,General  Antonio Elizalde,Urbana,6738,3212,3526
GUAYAS,General  Antonio Elizalde,Rural,5072,2563,2509
GUAYAS,Isidro Ayora,Total Isidro Ayora,14305,7249,7056
GUAYAS,Isidro Ayora,Urbana,8275,4099,4176
GUAYAS,Isidro Ayora,Rural,6030,3150,2880
IMBABURA,Total Imbabura,Total Imbabura,469879,226633,243246
IMBABURA,Total Imbabura,Urbana,245628,117109,128519
IMBABURA,Total Imbabura,Rural,224251,109524,114727
IMBABURA,Ibarra,Total Ibarra,217469,104110,113359
IMBABURA,Ibarra,Urbana,157941,75261,82680
IMBABURA,Ibarra,Rural,59528,28849,30679
IMBABURA,Antonio Ante,Total Antonio Ante,53771,25895,27876
IMBABURA,Antonio Ante,Urbana,25115,11968,13147
IMBABURA,Antonio Ante,Rural,28656,13927,14729
IMBABURA,Cotacachi,Total Cotacachi,53001,26134,26867
IMBABURA,Cotacachi,Urbana,10526,5028,5498
IMBABURA,Cotacachi,Rural,42475,21106,21369
IMBABURA,Otavalo,Total Otavalo,114303,55015,59288
IMBABURA,Otavalo,Urbana,41718,19838,21880
IMBABURA,Otavalo,Rural,72585,35177,37408
IMBABURA,Pimampiro,Total Pimampiro,13366,6542,6824
IMBABURA,Pimampiro,Urbana,5848,2822,3026
IMBABURA,Pimampiro,Rural,7518,3720,3798
IMBABURA,San Miguel de Urcuquí,Total San Miguel de Urcuquí,17969,8937,9032
IMBABURA,San Miguel de Urcuquí,Urbana,4480,2192,2288
IMBABURA,San Miguel de Urcuquí,Rural,13489,6745,6744
LOJA,Total Loja,Total Loja,485421,235444,249977
LOJA,Total Loja,Urbana,293339,139619,153720
LOJA,Total Loja,Rural,192082,95825,96257
LOJA,Loja,Total Loja,250028,119350,130678
LOJA,Loja,Urbana,203496,96587,106909
LOJA,Loja,Rural,46532,22763,23769
LOJA,Calvas,Total Calvas,26042,12767,13275
LOJA,Calvas,Urbana,13175,6294,6881
LOJA,Calvas,Rural,12867,6473,6394
LOJA,Catamayo,Total Catamayo,35240,17034,18206
LOJA,Catamayo,Urbana,27026,12986,14040
LOJA,Catamayo,Rural,8214,4048,4166
LOJA,Celica,Total Celica,14379,7301,7078
LOJA,Celica,Urbana,4486,2177,2309
LOJA,Celica,Rural,9893,5124,4769
LOJA,Chaguarpamba,Total Chaguarpamba,6857,3465,3392
LOJA,Chaguarpamba,Urbana,1342,647,695
LOJA,Chaguarpamba,Rural,5515,2818,2697
LOJA,Espíndola,Total Espíndola,14119,7146,6973
LOJA,Espíndola,Urbana,2073,1009,1064
LOJA,Espíndola,Rural,12046,6137,5909
LOJA,Gonzanamá,Total Gonzanamá,12247,6076,6171
LOJA,Gonzanamá,Urbana,1973,957,1016
LOJA,Gonzanamá,Rural,10274,5119,5155
LOJA,Macará,Total Macará,18215,8964,9251
LOJA,Macará,Urbana,12454,5955,6499
LOJA,Macará,Rural,5761,3009,2752
LOJA,Paltas,Total Paltas,22841,11310,11531
LOJA,Paltas,Urbana,7831,3711,4120
LOJA,Paltas,Rural,15010,7599,7411
LOJA,Puyango,Total Puyango,16257,8034,8223
LOJA,Puyango,Urbana,5981,2810,3171
LOJA,Puyango,Rural,10276,5224,5052
LOJA,Saraguro,Total Saraguro,29111,13631,15480
LOJA,Saraguro,Urbana,4656,2160,2496
LOJA,Saraguro,Rural,24455,11471,12984
LOJA,Sozoranga,Total Sozoranga,6970,3502,3468
LOJA,Sozoranga,Urbana,908,445,463
LOJA,Sozoranga,Rural,6062,3057,3005
LOJA,Zapotillo,Total Zapotillo,14571,7462,7109
LOJA,Zapotillo,Urbana,3599,1743,1856
LOJA,Zapotillo,Rural,10972,5719,5253
LOJA,Pindal,Total Pindal,10409,5362,5047
LOJA,Pindal,Urbana,2660,1328,1332
LOJA,Pindal,Rural,7749,4034,3715
LOJA,Quilanga,Total Quilanga,3971,1958,2013
LOJA,Quilanga,Urbana,934,437,497
LOJA,Quilanga,Rural,3037,1521,1516
LOJA,Olmedo,Total Olmedo,4164,2082,2082
LOJA,Olmedo,Urbana,745,373,372
LOJA,Olmedo,Rural,3419,1709,1710
LOS RIOS,Total Los Ríos,Total Los Ríos,898652,443391,455261
LOS RIOS,Total Los Ríos,Urbana,485223,233897,251326
LOS RIOS,Total Los Ríos,Rural,413429,209494,203935
LOS RIOS,Babahoyo,Total Babahoyo,178509,87115,91394
LOS RIOS,Babahoyo,Urbana,98251,46999,51252
LOS RIOS,Babahoyo,Rural,80258,40116,40142
LOS RIOS,Baba,Total Baba,45296,22938,22358
LOS RIOS,Baba,Urbana,6746,3243,3503
LOS RIOS,Baba,Rural,38550,19695,18855
LOS RIOS,Montalvo,Total Montalvo,28354,13987,14367
LOS RIOS,Montalvo,Urbana,16248,7827,8421
LOS RIOS,Montalvo,Rural,12106,6160,5946
LOS RIOS,Puebloviejo,Total Puebloviejo,40961,20054,20907
LOS RIOS,Puebloviejo,Urbana,9646,4655,4991
LOS RIOS,Puebloviejo,Rural,31315,15399,15916
LOS RIOS,Quevedo,Total Quevedo,206008,99970,106038
LOS RIOS,Quevedo,Urbana,177792,85951,91841
LOS RIOS,Quevedo,Rural,28216,14019,14197
LOS RIOS,Urdaneta,Total Urdaneta,33151,16524,16627
LOS RIOS,Urdaneta,Urbana,7216,3480,3736
LOS RIOS,Urdaneta,Rural,25935,13044,12891
LOS RIOS,Ventanas,Total Ventanas,73211,35848,37363
LOS RIOS,Ventanas,Urbana,41531,19964,21567
LOS RIOS,Ventanas,Rural,31680,15884,15796
LOS RIOS,Vinces,Total Vinces,80909,40487,40422
LOS RIOS,Vinces,Urbana,35064,16704,18360
LOS RIOS,Vinces,Rural,45845,23783,22062
LOS RIOS,Palenque,Total Palenque,24838,12718,12120
LOS RIOS,Palenque,Urbana,7258,3534,3724
LOS RIOS,Palenque,Rural,17580,9184,8396
LOS RIOS,Buena Fe,Total Buena Fe,74410,36756,37654
LOS RIOS,Buena Fe,Urbana,46779,22616,24163
LOS RIOS,Buena Fe,Rural,27631,14140,13491
LOS RIOS,Valencia,Total Valencia,51509,25948,25561
LOS RIOS,Valencia,Urbana,22996,11237,11759
LOS RIOS,Valencia,Rural,28513,14711,13802
LOS RIOS,Mocache,Total Mocache,42026,21161,20865
LOS RIOS,Mocache,Urbana,9535,4619,4916
LOS RIOS,Mocache,Rural,32491,16542,15949
LOS RIOS,Quinsaloma,Total Quinsaloma,19470,9885,9585
LOS RIOS,Quinsaloma,Urbana,6161,3068,3093
LOS RIOS,Quinsaloma,Rural,13309,6817,6492
MANABI,Total Manabí,Total Manabí,1592840,787046,805794
MANABI,Total Manabí,Urbana,924325,446082,478243
MANABI,Total Manabí,Rural,668515,340964,327551
MANABI,Portoviejo,Total Portoviejo,322925,157943,164982
MANABI,Portoviejo,Urbana,244129,117312,126817
MANABI,Portoviejo,Rural,78796,40631,38165
MANABI,Bolívar,Total Bolívar,41827,20556,21271
MANABI,Bolívar,Urbana,20011,9542,10469
MANABI,Bolívar,Rural,21816,11014,10802
MANABI,Chone,Total Chone,128166,62552,65614
MANABI,Chone,Urbana,54629,25540,29089
MANABI,Chone,Rural,73537,37012,36525
MANABI,El Carmen,Total El Carmen,120936,59947,60989
MANABI,El Carmen,Urbana,52366,25060,27306
MANABI,El Carmen,Rural,68570,34887,33683
MANABI,Flavio Alfaro,Total Flavio Alfaro,26415,13024,13391
MANABI,Flavio Alfaro,Urbana,8312,3908,4404
MANABI,Flavio Alfaro,Rural,18103,9116,8987
MANABI,Jipijapa,Total Jipijapa,78117,39164,38953
MANABI,Jipijapa,Urbana,45382,21982,23400
MANABI,Jipijapa,Rural,32735,17182,15553
MANABI,Junín,Total Junín,22324,11264,11060
MANABI,Junín,Urbana,7332,3567,3765
MANABI,Junín,Rural,14992,7697,7295
MANABI,Manta,Total Manta,271145,131534,139611
MANABI,Manta,Urbana,258697,125295,133402
MANABI,Manta,Rural,12448,6239,6209
MANABI,Montecristi,Total Montecristi,99937,48871,51066
MANABI,Montecristi,Urbana,71066,34273,36793
MANABI,Montecristi,Rural,28871,14598,14273
MANABI,Paján,Total Paján,41879,21618,20261
MANABI,Paján,Urbana,7686,3744,3942
MANABI,Paján,Rural,34193,17874,16319
MANABI,Pichincha,Total Pichincha,30380,15454,14926
MANABI,Pichincha,Urbana,4406,2136,2270
MANABI,Pichincha,Rural,25974,13318,12656
MANABI,Rocafuerte,Total Rocafuerte,42688,21347,21341
MANABI,Rocafuerte,Urbana,11848,5783,6065
MANABI,Rocafuerte,Rural,30840,15564,15276
MANABI,Santa Ana,Total Santa Ana,51462,25953,25509
MANABI,Santa Ana,Urbana,11918,5798,6120
MANABI,Santa Ana,Rural,39544,20155,19389
MANABI,Sucre,Total Sucre,62841,31412,31429
MANABI,Sucre,Urbana,22209,10989,11220
MANABI,Sucre,Rural,40632,20423,20209
MANABI,Tosagua,Total Tosagua,42853,21382,21471
MANABI,Tosagua,Urbana,11317,5447,5870
MANABI,Tosagua,Rural,31536,15935,15601
MANABI,24 de Mayo,Total 24 de Mayo,31473,16035,15438
MANABI,24 de Mayo,Urbana,6607,3233,3374
MANABI,24 de Mayo,Rural,24866,12802,12064
MANABI,Pedernales,Total Pedernales,70408,35284,35124
MANABI,Pedernales,Urbana,27068,13059,14009
MANABI,Pedernales,Rural,43340,22225,21115
MANABI,Olmedo,Total Olmedo,10090,5128,4962
MANABI,Olmedo,Urbana,2684,1294,1390
MANABI,Olmedo,Rural,7406,3834,3572
MANABI,Puerto López,Total Puerto López,25630,12988,12642
MANABI,Puerto López,Urbana,12598,6387,6211
MANABI,Puerto López,Rural,13032,6601,6431
MANABI,Jama,Total Jama,16588,8380,8208
MANABI,Jama,Urbana,5259,2603,2656
MANABI,Jama,Rural,11329,5777,5552
MANABI,Jaramijó,Total Jaramijó,29759,14872,14887
MANABI,Jaramijó,Urbana,28397,14160,14237
MANABI,Jaramijó,Rural,1362,712,650
MANABI,San Vicente,Total San Vicente,24997,12338,12659
MANABI,San Vicente,Urbana,10404,4970,5434
MANABI,San Vicente,Rural,14593,7368,7225
MORONA SANTIAGO,Total Morona Santiago,Total Morona Santiago,192508,94845,97663
MORONA SANTIAGO,Total Morona Santiago,Urbana,62836,30185,32651
MORONA SANTIAGO,Total Morona Santiago,Rural,129672,64660,65012
MORONA SANTIAGO,Morona,Total Morona,54935,26816,28119
MORONA SANTIAGO,Morona,Urbana,22398,10881,11517
MORONA SANTIAGO,Morona,Rural,32537,15935,16602
MORONA SANTIAGO,Gualaquiza,Total Gualaquiza,21892,10777,11115
MORONA SANTIAGO,Gualaquiza,Urbana,9157,4375,4782
MORONA SANTIAGO,Gualaquiza,Rural,12735,6402,6333
MORONA SANTIAGO,Limón Indanza,Total Limón Indanza,9602,4652,4950
MORONA SANTIAGO,Limón Indanza,Urbana,3982,1886,2096
MORONA SANTIAGO,Limón Indanza,Rural,5620,2766,2854
MORONA SANTIAGO,Palora,Total Palora,11882,5925,5957
MORONA SANTIAGO,Palora,Urbana,5748,2784,2964
MORONA SANTIAGO,Palora,Rural,6134,3141,2993
MORONA SANTIAGO,Santiago,Total Santiago,9755,4830,4925
MORONA SANTIAGO,Santiago,Urbana,2349,1131,1218
MORONA SANTIAGO,Santiago,Rural,7406,3699,3707
MORONA SANTIAGO,Sucúa,Total Sucúa,23504,11326,12178
MORONA SANTIAGO,Sucúa,Urbana,10846,5082,5764
MORONA SANTIAGO,Sucúa,Rural,12658,6244,6414
MORONA SANTIAGO,Huamboya,Total Huamboya,10830,5344,5486
MORONA SANTIAGO,Huamboya,Urbana,1312,611,701
MORONA SANTIAGO,Huamboya,Rural,9518,4733,4785
MORONA SANTIAGO,San Juan Bosco,Total San Juan Bosco,4372,2190,2182
MORONA SANTIAGO,San Juan Bosco,Urbana,1613,777,836
MORONA SANTIAGO,San Juan Bosco,Rural,2759,1413,1346
MORONA SANTIAGO,Taisha,Total Taisha,26700,13325,13375
MORONA SANTIAGO,Taisha,Urbana,1864,893,971
MORONA SANTIAGO,Taisha,Rural,24836,12432,12404
MORONA SANTIAGO,Logroño,Total Logroño,7484,3776,3708
MORONA SANTIAGO,Logroño,Urbana,1382,672,710
MORONA SANTIAGO,Logroño,Rural,6102,3104,2998
MORONA SANTIAGO,Pablo Sexto,Total Pablo Sexto,2267,1146,1121
MORONA SANTIAGO,Pablo Sexto,Urbana,1031,518,513
MORONA SANTIAGO,Pablo Sexto,Rural,1236,628,608
MORONA SANTIAGO,Tiwintza,Total Tiwintza,9285,4738,4547
MORONA SANTIAGO,Tiwintza,Urbana,1154,575,579
MORONA SANTIAGO,Tiwintza,Rural,8131,4163,3968
NAPO,Total Napo,Total Napo,131675,65517,66158
NAPO,Total Napo,Urbana,44675,21443,23232
NAPO,Total Napo,Rural,87000,44074,42926
NAPO,Tena,Total Tena,80816,40128,40688
NAPO,Tena,Urbana,29724,14253,15471
NAPO,Tena,Rural,51092,25875,25217
NAPO,Archidona,Total Archidona,30488,15270,15218
NAPO,Archidona,Urbana,7353,3474,3879
NAPO,Archidona,Rural,23135,11796,11339
NAPO,El Chaco,Total El Chaco,9252,4629,4623
NAPO,El Chaco,Urbana,4353,2161,2192
NAPO,El Chaco,Rural,4899,2468,2431
NAPO,Quijos,Total Quijos,6472,3158,3314
NAPO,Quijos,Urbana,1972,935,1037
NAPO,Quijos,Rural,4500,2223,2277
NAPO,Carlos Julio Arosemena Tola,Total Carlos Julio Arosemena Tola,4647,2332,2315
NAPO,Carlos Julio Arosemena Tola,Urbana,1273,620,653
NAPO,Carlos Julio Arosemena Tola,Rural,3374,1712,1662
PASTAZA,Total Pastaza,Total Pastaza,111915,55042,56873
PASTAZA,Total Pastaza,Urbana,38386,18580,19806
PASTAZA,Total Pastaza,Rural,73529,36462,37067
PASTAZA,Pastaza,Total Pastaza,82754,40422,42332
PASTAZA,Pastaza,Urbana,33325,16042,17283
PASTAZA,Pastaza,Rural,49429,24380,25049
PASTAZA,Mera,Total Mera,15087,7388,7699
PASTAZA,Mera,Urbana,853,425,428
PASTAZA,Mera,Rural,14234,6963,7271
PASTAZA,Santa Clara,Total Santa Clara,4521,2330,2191
PASTAZA,Santa Clara,Urbana,1831,932,899
PASTAZA,Santa Clara,Rural,2690,1398,1292
PASTAZA,Arajuno,Total Arajuno,9553,4902,4651
PASTAZA,Arajuno,Urbana,2377,1181,1196
PASTAZA,Arajuno,Rural,7176,3721,3455
PICHINCHA,Total Pichincha,Total Pichincha,3089473,1490557,1598916
PICHINCHA,Total Pichincha,Urbana,1958079,941175,1016904
PICHINCHA,Total Pichincha,Rural,1131394,549382,582012
PICHINCHA,Distrito Metropolitano de Quito,Total Distrito Metropolitano de Quito,2679722,1291774,1387948
PICHINCHA,Distrito Metropolitano de Quito,Urbana,1763275,847321,915954
PICHINCHA,Distrito Metropolitano de Quito,Rural,916447,444453,471994
PICHINCHA,Cayambe,Total Cayambe,105267,51000,54267
PICHINCHA,Cayambe,Urbana,44559,21637,22922
PICHINCHA,Cayambe,Rural,60708,29363,31345
PICHINCHA,Mejía,Total Mejía,101894,48864,53030
PICHINCHA,Mejía,Urbana,24188,11473,12715
PICHINCHA,Mejía,Rural,77706,37391,40315
PICHINCHA,Pedro Moncayo,Total Pedro Moncayo,40483,19839,20644
PICHINCHA,Pedro Moncayo,Urbana,13019,6409,6610
PICHINCHA,Pedro Moncayo,Rural,27464,13430,14034
PICHINCHA,Rumiñahui,Total Rumiñahui,107904,51939,55965
PICHINCHA,Rumiñahui,Urbana,96647,46490,50157
PICHINCHA,Rumiñahui,Rural,11257,5449,5808
PICHINCHA,San Miguel de los Bancos,Total San Miguel de los Bancos,13661,6833,6828
PICHINCHA,San Miguel de los Bancos,Urbana,5396,2626,2770
PICHINCHA,San Miguel de los Bancos,Rural,8265,4207,4058
PICHINCHA,Pedro Vicente Maldonado,Total Pedro Vicente Maldonado,15475,7720,7755
PICHINCHA,Pedro Vicente Maldonado,Urbana,7162,3432,3730
PICHINCHA,Pedro Vicente Maldonado,Rural,8313,4288,4025
PICHINCHA,Puerto Quito,Total Puerto Quito,25067,12588,12479
PICHINCHA,Puerto Quito,Urbana,3833,1787,2046
PICHINCHA,Puerto Quito,Rural,21234,10801,10433
TUNGURAHUA,Total Tungurahua,Total Tungurahua,563532,271101,292431
TUNGURAHUA,Total Tungurahua,Urbana,225249,108090,117159
TUNGURAHUA,Total Tungurahua,Rural,338283,163011,175272
TUNGURAHUA,Ambato,Total Ambato,370664,178019,192645
TUNGURAHUA,Ambato,Urbana,177316,85077,92239
TUNGURAHUA,Ambato,Rural,193348,92942,100406
TUNGURAHUA,Baños de Agua Santa,Total Baños de Agua Santa,21908,10686,11222
TUNGURAHUA,Baños de Agua Santa,Urbana,14100,6702,7398
TUNGURAHUA,Baños de Agua Santa,Rural,7808,3984,3824
TUNGURAHUA,Cevallos,Total Cevallos,10433,5032,5401
TUNGURAHUA,Cevallos,Urbana,3754,1800,1954
TUNGURAHUA,Cevallos,Rural,6679,3232,3447
TUNGURAHUA,Mocha,Total Mocha,7260,3553,3707
TUNGURAHUA,Mocha,Urbana,1516,714,802
TUNGURAHUA,Mocha,Rural,5744,2839,2905
TUNGURAHUA,Patate,Total Patate,13879,6783,7096
TUNGURAHUA,Patate,Urbana,2514,1245,1269
TUNGURAHUA,Patate,Rural,11365,5538,5827
TUNGURAHUA,Quero,Total Quero,19084,9335,9749
TUNGURAHUA,Quero,Urbana,3269,1581,1688
TUNGURAHUA,Quero,Rural,15815,7754,8061
TUNGURAHUA,San Pedro de Pelileo,Total San Pedro de Pelileo,63897,30669,33228
TUNGURAHUA,San Pedro de Pelileo,Urbana,11403,5437,5966
TUNGURAHUA,San Pedro de Pelileo,Rural,52494,25232,27262
TUNGURAHUA,Santiago de Píllaro,Total Santiago de Píllaro,42497,20289,22208
TUNGURAHUA,Santiago de Píllaro,Urbana,9816,4776,5040
TUNGURAHUA,Santiago de Píllaro,Rural,32681,15513,17168
TUNGURAHUA,Tisaleo,Total Tisaleo,13910,6735,7175
TUNGURAHUA,Tisaleo,Urbana,1561,758,803
TUNGURAHUA,Tisaleo,Rural,12349,5977,6372
ZAMORA CHINCHIPE,Total Zamora Chinchipe,Total Zamora Chinchipe,110973,55421,55552
ZAMORA CHINCHIPE,Total Zamora Chinchipe,Urbana,51424,25243,26181
ZAMORA CHINCHIPE,Total Zamora Chinchipe,Rural,59549,30178,29371
ZAMORA CHINCHIPE,Zamora,Total Zamora,30186,15004,15182
ZAMORA CHINCHIPE,Zamora,Urbana,17584,8678,8906
ZAMORA CHINCHIPE,Zamora,Rural,12602,6326,6276
ZAMORA CHINCHIPE,Chinchipe,Total Chinchipe,10337,5311,5026
ZAMORA CHINCHIPE,Chinchipe,Urbana,4154,2088,2066
ZAMORA CHINCHIPE,Chinchipe,Rural,6183,3223,2960
ZAMORA CHINCHIPE,Nangaritza,Total Nangaritza,6429,3238,3191
ZAMORA CHINCHIPE,Nangaritza,Urbana,2519,1224,1295
ZAMORA CHINCHIPE,Nangaritza,Rural,3910,2014,1896
ZAMORA CHINCHIPE,Yacuambi,Total Yacuambi,6391,3139,3252
ZAMORA CHINCHIPE,Yacuambi,Urbana,1626,782,844
ZAMORA CHINCHIPE,Yacuambi,Rural,4765,2357,2408
ZAMORA CHINCHIPE,Yantzaza,Total Yantzaza,23370,11539,11831
ZAMORA CHINCHIPE,Yantzaza,Urbana,13335,6503,6832
ZAMORA CHINCHIPE,Yantzaza,Rural,10035,5036,4999
ZAMORA CHINCHIPE,El Pangui,Total El Pangui,12768,6300,6468
ZAMORA CHINCHIPE,El Pangui,Urbana,5340,2602,2738
ZAMORA CHINCHIPE,El Pangui,Rural,7428,3698,3730
ZAMORA CHINCHIPE,Centinela del Cóndor,Total Centinela del Cóndor,7882,3970,3912
ZAMORA CHINCHIPE,Centinela del Cóndor,Urbana,2930,1456,1474
ZAMORA CHINCHIPE,Centinela del Cóndor,Rural,4952,2514,2438
ZAMORA CHINCHIPE,Palanda,Total Palanda,8873,4524,4349
ZAMORA CHINCHIPE,Palanda,Urbana,2353,1142,1211
ZAMORA CHINCHIPE,Palanda,Rural,6520,3382,3138
ZAMORA CHINCHIPE,Paquisha,Total Paquisha,4737,2396,2341
ZAMORA CHINCHIPE,Paquisha,Urbana,1583,768,815
ZAMORA CHINCHIPE,Paquisha,Rural,3154,1628,1526
GALAPAGOS,Total Galápagos,Total Galápagos,28583,14380,14203
GALAPAGOS,Total Galápagos,Urbana,22741,11330,11411
GALAPAGOS,Total Galápagos,Rural,5842,3050,2792
GALAPAGOS,San Cristóbal,Total San Cristóbal,8300,4179,4121
GALAPAGOS,San Cristóbal,Urbana,7290,3644,3646
GALAPAGOS,San Cristóbal,Rural,1010,535,475
GALAPAGOS,Isabela,Total Isabela,3050,1564,1486
GALAPAGOS,Isabela,Urbana,2755,1390,1365
GALAPAGOS,Isabela,Rural,295,174,121
GALAPAGOS,Santa Cruz,Total Santa Cruz,17233,8637,8596
GALAPAGOS,Santa Cruz,Urbana,12696,6296,6400
GALAPAGOS,Santa Cruz,Rural,4537,2341,2196
SUCUMBIOS,Total Sucumbíos,Total Sucumbíos,199014,100167,98847
SUCUMBIOS,Total Sucumbíos,Urbana,81034,39353,41681
SUCUMBIOS,Total Sucumbíos,Rural,117980,60814,57166
SUCUMBIOS,Lago Agrio,Total Lago Agrio,105044,52497,52547
SUCUMBIOS,Lago Agrio,Urbana,55627,26947,28680
SUCUMBIOS,Lago Agrio,Rural,49417,25550,23867
SUCUMBIOS,Gonzalo Pizarro,Total Gonzalo Pizarro,10356,5201,5155
SUCUMBIOS,Gonzalo Pizarro,Urbana,2083,1039,1044
SUCUMBIOS,Gonzalo Pizarro,Rural,8273,4162,4111
SUCUMBIOS,Putumayo,Total Putumayo,9018,4613,4405
SUCUMBIOS,Putumayo,Urbana,2012,943,1069
SUCUMBIOS,Putumayo,Rural,7006,3670,3336
SUCUMBIOS,Shushufindi,Total Shushufindi,50826,25687,25139
SUCUMBIOS,Shushufindi,Urbana,16328,7954,8374
SUCUMBIOS,Shushufindi,Rural,34498,17733,16765
SUCUMBIOS,Sucumbíos,Total Sucumbíos,3174,1609,1565
SUCUMBIOS,Sucumbíos,Urbana,746,364,382
SUCUMBIOS,Sucumbíos,Rural,2428,1245,1183
SUCUMBIOS,Cascales,Total Cascales,11744,5938,5806
SUCUMBIOS,Cascales,Urbana,2510,1201,1309
SUCUMBIOS,Cascales,Rural,9234,4737,4497
SUCUMBIOS,Cuyabeno,Total Cuyabeno,8852,4622,4230
SUCUMBIOS,Cuyabeno,Urbana,1728,905,823
SUCUMBIOS,Cuyabeno,Rural,7124,3717,3407
ORELLANA,Total Orellana,Total Orellana,182166,92241,89925
ORELLANA,Total Orellana,Urbana,73338,36178,37160
ORELLANA,Total Orellana,Rural,108828,56063,52765
ORELLANA,Francisco de Orellana,Total Francisco de Orellana,95130,48163,46967
ORELLANA,Francisco de Orellana,Urbana,51281,25371,25910
ORELLANA,Francisco de Orellana,Rural,43849,22792,21057
ORELLANA,Aguarico,Total Aguarico,6872,3487,3385
ORELLANA,Aguarico,Urbana,657,321,336
ORELLANA,Aguarico,Rural,6215,3166,3049
ORELLANA,La Joya de los Sachas,Total La Joya de los Sachas,52444,26450,25994
ORELLANA,La Joya de los Sachas,Urbana,16023,7876,8147
ORELLANA,La Joya de los Sachas,Rural,36421,18574,17847
ORELLANA,Loreto,Total Loreto,27720,14141,13579
ORELLANA,Loreto,Urbana,5377,2610,2767
ORELLANA,Loreto,Rural,22343,11531,10812
SANTO DOMINGO DE LOS TSACHILAS,Total Santo Domingo de los Tsáchilas,Total Santo Domingo de los Tsáchilas,492969,240169,252800
SANTO DOMINGO DE LOS TSACHILAS,Total Santo Domingo de los Tsáchilas,Urbana,370300,177629,192671
SANTO DOMINGO DE LOS TSACHILAS,Total Santo Domingo de los Tsáchilas,Rural,122669,62540,60129
SANTO DOMINGO DE LOS TSACHILAS,Santo Domingo,Total Santo Domingo,441583,215061,226522
SANTO DOMINGO DE LOS TSACHILAS,Santo Domingo,Urbana,334826,160633,174193
SANTO DOMINGO DE LOS TSACHILAS,Santo Domingo,Rural,106757,54428,52329
SANTO DOMINGO DE LOS TSACHILAS,La Concordia,Total La Concordia,51386,25108,26278
SANTO DOMINGO DE LOS TSACHILAS,La Concordia,Urbana,35474,16996,18478
SANTO DOMINGO DE LOS TSACHILAS,La Concordia,Rural,15912,8112,7800
SANTA ELENA,Total Santa Elena,Total Santa Elena,385735,191303,194432
SANTA ELENA,Total Santa Elena,Urbana,201785,98917,102868
SANTA ELENA,Total Santa Elena,Rural,183950,92386,91564
SANTA ELENA,Santa Elena,Total Santa Elena,186687,93101,93586
SANTA ELENA,Santa Elena,Urbana,54565,26493,28072
SANTA ELENA,Santa Elena,Rural,132122,66608,65514
SANTA ELENA,La Libertad,Total La Libertad,112247,54865,57382
SANTA ELENA,La Libertad,Urbana,112154,54814,57340
SANTA ELENA,La Libertad,Rural,93,51,42
SANTA ELENA,Salinas,Total Salinas,86801,43337,43464
SANTA ELENA,Salinas,Urbana,35066,17610,17456
SANTA ELENA,Salinas,Rural,51735,25727,26008
